XXXXXXXXXXXX  
X. * X     XXX
X.   X *  *  X
X    X*XXXX  X
X *      XX  X
X    X X  * XX
X@XXXX XX* * X
XXX    * * * X
  X    X     X
  XXXXXXXXXXXX